1 1 2 2 3 3 2 2 1 1
0 5 5 4 4 1 1 4 4 5
0 3 3 2 5 5 2 3 3 0
0 0 2 4 4 3 4 4 2 0
0 0 4 3 1 1 3 4 0 0
0 0 0 0 0 0 0 0 0 0
0 0 0 0 0 0 0 0 0 0
0 0 0 0 0 0 0 0 0 0
0 0 0 0 0 0 0 0 0 0
0 0 0 0 0 0 0 0 0 0
0 0 0 0 0 0 0 0 0 0
0 0 0 0 0 0 0 0 0 0
0 0 0 0 0 0 0 0 0 0
0 0 0 0 0 0 0 0 0 0
0 0 0 0 0 0 0 0 0 0