1 1 0 0 6 6 0 0 2 2
0 3 3 0 0 2 2 0 0 5
2 2 0 0 4 4 0 0 1 1
0 4 4 0 0 3 3 0 0 5
5 5 6 6 1 1 2 2 3 3
4 4 3 3 5 5 6 6 1 1
0 0 0 0 0 0 0 0 0 0
0 0 0 0 0 0 0 0 0 0
0 0 0 0 0 0 0 0 0 0
0 0 0 0 0 0 0 0 0 0
0 0 0 0 0 0 0 0 0 0
0 0 0 0 0 0 0 0 0 0
0 0 0 0 0 0 0 0 0 0
0 0 0 0 0 0 0 0 0 0
0 0 0 0 0 0 0 0 0 0